1111111111111
1001P0000C0C1
100001111C001
1P0011E000001
1111111111111
