1111111111111111111111111111111111
1E0000000000000C00000C000000000001
1000101001000001010010000000101001
1010010010101010001001000000010101
1P0000000C00C0000000000000000000C1
11111111111111111111111111111111111
