1111111111111
1000000100001
10000001C0001
1000PC01E0001
1111111111111
