111111111
1P00000C1
100010001
10000E001
111111111
